5 10
|--------|
|...|..-.|
|...|..@.|
|......-.|
|--------|